+----------------------------------+
|___xxxxxxxxxxxxxxxxxxxxxxxxxxxx___|
|___xxxxxxxxxxxxxxxxxxxxxxxxxxxx___|
|___xxxxxxxxxxxxxxxxxxxxxxxxxxxx___|
|___xxxxxxxxxxxxxxxxxxxxxxxxxxxx___|
|___xxxxxxxxxxxxxxxxxxxxxxxxxxxx___|
|__________________________________|
|__________________________________|
|__________________________________|
|__________________________________|
|__________________________________|
|__________________________________|
|_______________o__________________|
|______________===_________________|